111111111111111111111111
100000000000000000000001
1000E0000000000000000001
100000000000000000000001
100000CCCC0000CCCC000001
1P0000CCCC0000CCCC000001
100000CCCC0000CCCC000001
1000000000CCCC0000000001
1000000000CCCC0000000001
1000000000CCCC0000000001
100000CCCCCCCCCCCCC00001
100000CCCCCCCCCCCCC00001
100000CCCC00000CCCC00001
111111111111111111111111
