1111111111111111111
1P0C00010C000000001
1000E00100000000001
1000000100000000001
100C00010C000000001
100C00010C000000001
100C00010C000000001
1111111111111111111
