111111111111111111
1P0C0000C000000001
1000E0000000000001
100000000000000001
100C0000C0000E0001
100C0000C000000000
100C0000C0000P0001
111111111111111111
