111111111111111111
1P0C0000C000000001
1000E0000000000001
10000000000000001
100C0000C00000001
100C0000C000000000
100C0000C000000001
111111111111111111
